ɒ	A
ɑː	AA
æ	AE
ʌ	AH
ɔː	AO
aʊ	AW
ə	AX
aɪ	AY
b	B
tʃ	CH
d	D
ð	DH
e	EH
ɜː	ER
eɪ	EY
f	F
ɡ	G
h	HH
ɪ	IH
iː	IY
dʒ	JH
k	K
l	L
m	M
n	N
ŋ	NG
əʊ	OW
ɔɪ	OY
p	P
r	R
s	S
ʃ	SH
-	SL
t	T
θ	TH
ʊ	UH
uː	UW
v	V
w	W
j	Y
z	Z
ʒ	ZH